NO textures/CodamDarkNorth.png
SO textures/CodamDarkSouth.png
WE textures/CodamDarkWest.png
EA textures/CodamDarkEast.png

D0 textures/CodamBlacksmall.png
D1 textures/CodamBlacksmall.png
D2 textures/CodamBlacksmall.png

S0 textures/CodamDavid.png
S1 textures/CodamVictoria.png
S2 textures/CodamRene.png

FI textures/CodamDarkFloor2.png
CI textures/CodamDarkCeiling.png

        1111111111111111111111111
        1011000000110000000000001
        100000000111000000C000001
        1001000000000000000000001
111111111011000001110000000000001
10000000001100000111011111O111111
11110111111111011100000010001
11110111111111011101010010001
11000000110101011100000010001
10000000000000001100000010001
10000000000000001101010010001
1100000111010101111101111000111
11110111 11101N1 101111010001
11111111 1111111 111111111111