NO textures/wolftextures1.png
SO    textures/wolftextures2.png
WE textures/wolftextures3.png
EA            textures/wolftextures4.png

D0 textures/Door0.png
D1 textures/Door1.png
D2 textures/Door2.png

S0 textures/Door0.png
S1 textures/Door1.png
S2 textures/Door2.png

CI textures/ea.png
FI textures/we.png

1111111111111111111111
1000000000000000000001
1000000000000000000001
1000000000000000000001
1000000000000S00000001
1000000000000000000001
1111111111100000000001
1MMMMMMMMM100000000001
1000000000000000000001
1000000000100000000001
1000000000100000000001
1010101010100000000001
1000000000100000000001
1111111111111111111111