NO textures/wolftextures1.png
SO textures/wolftextures2.png
WE textures/wolftextures3.png
EA textures/wolftextures4.png

D0 textures/Door0.png
D1 textures/Door1.png
D2 textures/Door2.png

S0 textures/Door0.png
S1 textures/Door1.png
S2 textures/Door2.png

CI textures/wolftextures5.png
FI textures/wolftextures6.png

1111111111111
1000000000001
1000000000001
1MMMMMM100001
1S00000O00001
1MMMMMM100001
1000000000001
1000000000001
1111111111111