NO textures/wolftextures1.png
SO textures/wolftextures2.png
WE textures/wolftextures3.png
EA textures/wolftextures4.png

D0 textures/Door0.png
D1 textures/Door1.png
D2 textures/Door2.png

S0 textures/Door0.png
S1 textures/Door1.png
S2 textures/Door2.png

CI textures/wolftextures5.png
FI textures/wolftextures6.png

11111111111111111111111111111111111111111111111111
100000W0000000000000000000000000000000000000000001
10000000000000000000000000000000000000000000000001
10000000000000000000000000000000000000000000000001
10110000000000000000000000000000000000000000000001
10100001DDD000000000000000000000000000000000000001
10D00011000000000000000000000000000000000000000001
11100010000000000000000000000000000000000000000001
11111111111111111111111111111111111111111111111111