NO textures/wolftextures1.png
SO textures/wolftextures2.png
WE textures/wolftextures3.png
EA textures/wolftextures4.png

D0 textures/Door0.png
D1 textures/Door1.png
D2 textures/Door2.png

S0 textures/Door0.png
S1 textures/Door1.png
S2 textures/Door2.png

C 64,128,192
F 32,128,64

1111111
1E00001
1000001
1000001
1000001
1000001
1111111