NO textures/wolftextures1.png
SO textures/wolftextures2.png
WE textures/wolftextures3.png
EA textures/wolftextures4.png

DO textures/wolftextures5.png

C 64,128,192
F 32,128,64

11111111111111111111
1E001000000000000001
11101000000000000001
10000000000000000001
10101011000000000001
101M1001000000000001
10000M01000000000001
10111100000000000001
10000000000000000001
11111111111111111111