NO textures/no.png
SO textures/so.png
WE textures/we.png
EA textures/ea.png

C 64,128,192
F 32,128,64

1111111111111
1E00000001111
1000000000111
1000000000011
1011000000001
1010000111D11
10D0001100001
1110001000001
1111111111111