NO textures/wolftextures1.png
SO textures/wolftextures2.png
WE textures/wolftextures3.png
EA textures/wolftextures4.png

C 64,128,192
F 32,128,64

1111111111111
100000W001111
1000000000111
10000000000111111111111111111111111111111111111111
10110000000000000000000000000000000000000000000001
10100001DDD111111111111111111111111111111111111111
10D0001000001
1110001000001
1111111111111