NO textures/wolftextures1.png
SO    textures/wolftextures2.png
WE   textures/wolftextures3.png
EA            textures/wolftextures4.png

D0 textures/Door0.png
D1 textures/Door1.png
D2 textures/Door2.png

S0 textures/Sprite1.png
S1 textures/Sprite2.png
S2 textures/Sprite3.png

C                64,128,192
F 32,128,64

1111111111111
1CC0000001111
1CC0000000111
10C00000000111111111111111111111111111111111111111
1011000N000000000000000000000000000000000000000001
10100001DDD111111111111111111111111111111111111111
10D0001000001
1110001000001
1111111111111